4 12 20 9 3 4 3 2 6 5 9 9 10 4 11 12 7 21 5 12 12 8 10 5 1 22 5 22 12 11 3 10 3 13 22 21 
12 7 15 22 21 4 12 1 4 7 22 6 8 12 2 8 1 8 12 4 4 7 21 21 1 2 8 8 3 6 19 5 22 8 9 21 
9 6 10 2 5 7 7 1 9 12 7 5 12 20 9 6 3 7 22 21 2 4 2 22 11 4 22 5 21 13 10 10 10 8 1 2 
6 12 21 4 2 1 8 21 12 12 10 10 8 6 22 4 22 16 7 6 2 21 4 21 20 8 22 10 5 10 21 8 1 5 3 9 
21 5 2 21 22 7 20 9 6 5 7 9 2 1 22 7 21 10 12 5 5 9 11 4 11 22 6 16 10 8 4 3 10 9 3 10 
